12:12
2 18 2 68 0 84 84 0 36 2 18 2
18 0 0 0 52 6 0 52 0 0 0 18
2 0 18 0 0 0 0 0 0 18 0 2
0 0 4 18 0 0 0 0 18 18 2 18
68 0 0 52 18 0 0 18 0 0 18 18
52 52 0 0 0 3 0 0 0 84 216 18
68 0 0 52 18 0 0 18 0 0 18 18
6 0 4 18 0 0 0 0 18 18 2 18
0 0 18 0 0 0 0 0 0 18 0 2
2 0 0 0 0 52 52 0 0 4 0 2
52 6 0 6 4 18 18 4 0 0 0 52
116 84 2 0 18 2 2 18 0 2 100 36