3 0 0 0 0 0 0 0 0 0 0 6
2 2 0 18 4 18 0 18 4 18 0 18
85 18 0 18 52 18 0 18 84 18 0 2
4 18 0 18 2 18 0 18 2 18 0 18
0 0 0 0 0 0 0 0 0 0 0 0
0 2 18 0 18 2 0 18 18 0 18 18
0 18 18 0 18 18 0 2 18 0 18 2
0 0 0 0 0 0 0 0 0 0 0 0
0 20 4 0 52 4 0 20 4 0 52 4
0 4 84 0 4 84 0 4 84 0 4 84
0 0 0 0 18 18 9 0 0 0 18 18
0 18 18 0 0 0 0 18 18 0 0 152
