12:12
84 18 18 18 18 18 18 2 2 2 2 2
0 18 0 0 0 0 2 18 20 2 85 2
0 18 0 18 2 0 18 2 52 2 6 2
0 2 0 18 13 0 2 18 0 0 0 18
0 6 0 18 18 18 18 2 0 0 0 0
0 0 0 0 0 0 0 0 0 0 18 2
0 0 0 0 18 52 0 0 0 0 2 18
0 18 20 0 84 18 0 18 4 0 18 2
0 36 18 0 18 52 0 68 18 0 52 18
0 18 20 0 52 18 0 18 4 0 18 4
0 36 18 0 18 84 0 52 18 0 0 3
0 18 4 0 0 0 0 18 52 0 0 8
