2 18 2 18 2 18 24 18 18 18 18 2
18 116 0 2 0 18 0 18 18 0 3 18
2 0 6 0 0 0 0 18 0 0 0 18
18 2 0 6 18 36 36 18 0 0 18 18
2 0 0 18 18 18 18 18 18 0 0 0
0 0 18 18 18 84 52 18 18 18 0 0
100 0 0 0 0 0 0 0 0 0 0 52
0 0 0 18 18 52 84 18 18 0 0 0
18 18 0 0 18 18 18 18 0 0 18 18
18 68 0 0 0 0 0 0 0 0 68 18
18 18 52 18 0 2 2 0 18 52 18 18
2 18 18 18 0 20 52 0 18 18 18 2
