4 2 4 2 0 2 2 0 2 4 2 4
2 4 2 0 0 18 1 0 0 2 4 2
84 2 6 6 0 0 0 0 6 6 2 84
20 2 0 6 6 6 6 6 6 0 2 20
52 2 0 0 6 0 0 6 0 0 2 52
0 52 2 0 0 0 0 0 0 2 52 0
0 0 52 2 0 0 0 2 2 52 0 0
0 0 0 0 0 0 0 0 0 0 0 84
2 0 52 0 2 0 2 0 52 84 0 2
52 6 2 84 2 0 2 0 0 2 6 52
52 0 20 2 18 3 18 2 0 0 0 52
2 52 2 18 18 24 18 18 2 52 20 2
