4 2 0 0 2 18 2 18 0 18 52 18
2 6 0 0 0 2 18 0 0 0 0 20
0 0 52 2 36 18 2 0 18 52 0 52
2 36 2 52 0 2 18 0 0 18 52 18
2 2 0 6 0 2 18 0 0 0 18 18
2 232 0 0 0 4 4 0 0 3 72 18
2 2 0 0 0 2 18 0 0 0 18 18
2 52 2 0 0 18 2 0 0 18 84 18
0 0 0 2 68 2 18 0 18 52 0 20
0 6 0 0 0 2 18 0 0 0 0 0
116 2 0 0 0 0 0 0 18 0 0 52
2 0 2 84 2 0 0 18 52 0 84 18
