18 0 0 0 0 0 18 52 18 0 4 85
18 0 18 3 18 0 18 0 18 0 2 36
0 0 18 8 18 0 0 0 0 6 0 0
0 18 2 18 2 18 0 18 2 0 18 18
0 18 18 2 18 18 0 0 0 0 0 0
6 0 0 0 0 0 0 18 2 84 2 18
0 18 18 18 18 18 0 18 52 2 52 18
0 0 68 100 52 18 0 0 0 0 0 0
0 36 18 52 100 18 0 2 2 6 2 2
4 18 18 18 4 18 0 2 18 0 18 2
100 52 18 36 0 18 0 18 2 11 2 18
52 100 68 0 0 0 0 2 18 2 18 2
